########
#S     #
###### #
#E   # #
#  #   #
########